wwwwwwww
w B    w
w    b w
w  g   w
w  g   w
w b    w
w c    w
w   ww w
wwwwwwww
